...............................
...............................
...............................
...............................
...............................
...............................
...............................
...............................
...............................
...............................
...............................
...............................
...............................
...............................
...............................
...............................
...............................
...............................
.........p.....................
.......11111111................
...............................
...............................
...............................
1111111111111111111111111111111